[
  {
    "type": "mapgen",
    "method": "json",
    "om_terrain": [
      [ "helipad_guard_post_north", "helipad_foundation_nw", "helipad_foundation_ne" ],
      [ "helipad_guard_post_south", "helipad_foundation_sw", "Helipad_foundation_se" ]
    ],
    "object": {
      "fill_ter": "t_wall_rammed_earth",
      "rows": [
        "~~~~~~~~~~~~~~~~~~~~~~~~~~~~~~~~~~~~~~~~~~~~~~~~~~~~~~~~~~~~~~~~~~~~~~~~",
        "~~~~~~~~~~~~~...........................................................",
        "~~~~~~~~~~~~~...........................................................",
        "~~~~~~~~~~~~~...........................................................",
        "~~~~~~~~~~~~~../////////////////////////////////////////////////////////",
        "~~~~~~~~~~~~~../||||||||||||||||||||||||||||||||||||||||||||||||||||||||",
        "~~~~~~~~~~~~~../|######################################################|",
        "~~~~~~~~~~~~~../|######################################################|",
        "~~~~~~~~~~~~~../|######################################################|",
        "~~~~~~~~~~~~~../|######################################################|",
        "~~~~~~~~~~~~~../|######################################################|",
        "~~~~~~~~~~~~~../|######################################################|",
        "~~~~~~~~~~~~~../|######################################################|",
        "~~~~~~~~~~~~~../|######################################################|",
        "~~~~~~~~~~~~~../|######################################################|",
        "~~~~~~~~~~~~~../|######################################################|",
        "~~~~~~~~~~~~~../|######################################################|",
        "~~~~~~~~~~~~~../|######################################################|",
        "~~~~~~~~~~~~~../|######################################################|",
        "~~~~~~~~~~~~~../|######################################################|",
        "~~~~~~~~~~~~~../|######################################################|",
        "~............../|######################################################|",
        "~............../|######################################################|",
        "~..//////r/r////|######################################################|",
        "~../|||||s|s||||||||||||||||||||||||||||||||||||||||||||||||||||||||||||",
        "~../|__________f|######################################################|",
        "~../|__________u|######################################################|",
        "~../|___________|######################################################|",
        "~../|___________|######################################################|",
        "~../|___________|######################################################|",
        "~../|___________|######################################################|",
        "~../|___________|######################################################|",
        "~../|_1_________|######################################################|",
        "~..r!___________|######################################################|",
        "~..rs___________|||####################################################|",
        "~../|_c_________Md|####################################################|",
        "~..r!___________W||####################################################|",
        "~..rs___________|######################################################|",
        "~../|___________|######################################################|",
        "~../|___________|######################################################|",
        "~../|___________|######################################################|",
        "~../|___________|######################################################|",
        "~../|___________|######################################################|",
        ".../|___________|######################################################|",
        ".../|__________f|######################################################|",
        "///|___________|######################################################|",
        "|||||||s||m||s||||||||||||||||||||||||||||||||||||||||||||||||||||||||||",
        "ooooooooooooooooooouooooooooooooooooooooooooooooooooouooooooooooooooooooo"
      ],
      "palettes": [ "bio_experiment_station_helipad_palette" ],
      "place_vehicles": [
        { "vehicle": "mounted_atgm", "x": 6, "y": 33, "chance": 100, "rotation": 270, "status": 1 },
        { "vehicle": "mounted_m2", "x": 6, "y": 36, "chance": 100, "rotation": 270, "status": 1 }
      ]
    }
  },
  {
    "type": "mapgen",
    "method": "json",
    "om_terrain": [ "helipad_guard_post_magazine" ],
    "weight": 400,
    "object": {
      "fill_ter": "t_floor",
      "rows": [
        "&&&&&&&&&&&&&&&&&&&&&&&&",
        "&&&&&&&&&&&&&&&&&&&&&&&&",
        "&&&&&&&&&&&&&&&&&&&&&&&&",
        "&&&&&&&&&&&&&&&&&&&&&&&&",
        "&&&&&&&&&&&&&&&&&&&&&&&&",
        "&&&&&&&&&&&&&&&&&&&&&&&&",
        "&&&&&&&&&&&&&&&&&&&&&&&&",
        "&&&&&&&&&&&||||||||&&&&&",
        "&&&&&&&&&&&|_____||&&&&&",
        "&&&&&&&&&&&|_111_||&&&&&",
        "&&&&&&&&&&&|_____u|&&&&&",
        "&&&&&&&&&&&|_ccc_||&&&&&",
        "&&&&&&&&&&&|_____||&&&&&",
        "&&&&&&&&&&&||||||||&&&&&",
        "&&&&&&&&&&&&&&&&&&&&&&&&",
        "&&&&&&&&&&&&&&&&&&&&&&&&",
        "&&&&&&&&&&&&&&&&&&&&&&&&",
        "&&&&&&&&&&&&&&&&&&&&&&&&",
        "&&&&&&&&&&&&&&&&&&&&&&&&",
        "&&&&&&&&&&&&&&&&&&&&&&&&",
        "&&&&&&&&&&&&&&&&&&&&&&&&",
        "&&&&&&&&&&&&&&&&&&&&&&&&",
        "&&&&&&&&&&&&&&&&&&&&&&&&",
        "&&&&&&&&&&&&&&&&&&&&&&&&"
      ],
      "palettes": [ "bio_experiment_station_helipad_palette" ]
    }
  }
]
