[
  {
    "type": "mapgen",
    "method": "json",
    "om_terrain": [
      [ "helipad_guard_post_north", "helipad_foundation_nw", "helipad_foundation_ne" ],
      [ "helipad_guard_post_south", "helipad_foundation_sw", "Helipad_foundation_se" ]
    ],
    "object": {
      "fill_ter": "t_wall_rammed_earth",
      "rows": [
        "~~~~~~~~~~~~~~~~~~~~~~~~~~~~~~~~~~~~~~~~~~~~~~~~~~~~~~~~~~~~~~~~~~~~~~~~",
        "~~~~~~~~~~~~~...........................................................",
        "~~~~~~~~~~~~~...........................................................",
        "~~~~~~~~~~~~~...........................................................",
        "~~~~~~~~~~~~~../////////////////////////////////////////////////////////",
        "~~~~~~~~~~~~~../||||||||||||||||||||||||||||||||||||||||||||||||||||||||",
        "~~~~~~~~~~~~~../|######################################################|",
        "~~~~~~~~~~~~~../|######################################################|",
        "~~~~~~~~~~~~~../|######################################################|",
        "~~~~~~~~~~~~~../|######################################################|",
        "~~~~~~~~~~~~~../|######################################################|",
        "~~~~~~~~~~~~~../|######################################################|",
        "~~~~~~~~~~~~~../|######################################################|",
        "~~~~~~~~~~~~~../|######################################################|",
        "~~~~~~~~~~~~~../|######################################################|",
        "~~~~~~~~~~~~~../|######################################################|",
        "~~~~~~~~~~~~~../|######################################################|",
        "~~~~~~~~~~~~~../|######################################################|",
        "~~~~~~~~~~~~~../|######################################################|",
        "~~~~~~~~~~~~~../|######################################################|",
        "~............../|######################################################|",
        "~............../|######################################################|",
        "~..//////rrr////|######################################################|",
        "~../|||||s!s||||||||||||||||||||||||||||||||||||||||||||||||||||||||||||",
        "~../|___________|######################################################|",
        "~../|___________|######################################################|",
        "~..rs___________|######################################################|",
        "~..r!___________|######################################################|",
        "~..rs___________|######################################################|",
        "~../|___________|######################################################|",
        "~../|___________|######################################################|",
        "~../|___________|######################################################|",
        "~../|___________|######################################################|",
        "~../|___________|######################################################|",
        "~../|___________|######################################################|",
        "~../|___________|######################################################|",
        "~../|___________|######################################################|",
        "~../|___________|######################################################|",
        "~../|___________|######################################################|",
        "~../|___________|######################################################|",
        "~../|___________|######################################################|",
        "~..rs___________|######################################################|",
        "~..r!___________|######################################################|",
        "...rs___________|######################################################|",
        ".../|___________|######################################################|",
        "///|___________|######################################################|",
        "|||||||s||m||s||||||||||||||||||||||||||||||||||||||||||||||||||||||||||",
        "ooooooooooooooooooouooooooooooooooooooooooooooooooooouooooooooooooooooooo"
      ],
      "palettes": [ "bio_experiment_station_helipad_palette" ]
    }
  }
]
