[
  {
    "type": "mapgen",
    "method": "json",
    "om_terrain": [
      [ "helipad_guard_post1", "helipad_foundation1", "helipad_foundation2" ],
      [ "helipad_guard_post2", "helipad_foundation3", "Helipad_foundation_4" ]
    ],
    "object": {
      "fill_ter": "t_wall_rammed_earth",
      "rows": [
        "~~~~~~~~~~~~~~~~~~~~~~~~~~~~~~~~~~~~~~~~~~~~~~~~~~~~~~~~~~~~~~~~~~~~~~~~",
        "~~~~~~~~~~~~~...........................................................",
        "~~~~~~~~~~~~~...........................................................",
        "~~~~~~~~~~~~~...........................................................",
        "~~~~~~~~~~~~~../////////////////////////////////////////////////////////",
        "~~~~~~~~~~~~~../||||||||||||||||||||||||||||||||||||||||||||||||||||||||",
        "~~~~~~~~~~~~~../|######################################################|",
        "~~~~~~~~~~~~~../|######################################################|",
        "~~~~~~~~~~~~~../|######################################################|",
        "~~~~~~~~~~~~~../|######################################################|",
        "~~~~~~~~~~~~~../|######################################################|",
        "~~~~~~~~~~~~~../|######################################################|",
        "~~~~~~~~~~~~~../|######################################################|",
        "~~~~~~~~~~~~~../|######################################################|",
        "~~~~~~~~~~~~~../|######################################################|",
        "~~~~~~~~~~~~~../|######################################################|",
        "~~~~~~~~~~~~~../|######################################################|",
        "~~~~~~~~~~~~~../|######################################################|",
        "~~~~~~~~~~~~~../|######################################################|",
        "~~~~~~~~~~~~~../|######################################################|",
        "~~~~~~~~~~~~~../|######################################################|",
        "~............../|######################################################|",
        "~............../|######################################################|",
        "~..//////r/r////|######################################################|",
        "~../|||||s|s||||||||||||||||||||||||||||||||||||||||||||||||||||||||||||",
        "~../|__________f|######################################################|",
        "~../|__________u|######################################################|",
        "~../|___________|######################################################|",
        "~../|___________|######################################################|",
        "~../|___________|######################################################|",
        "~../|___________|######################################################|",
        "~../|___________|######################################################|",
        "~../|_c_________|######################################################|",
        "~..r!___________|######################################################|",
        "~..rs___________|||####################################################|",
        "~../|_c_________Md|####################################################|",
        "~..r!___________W||###################################################|L",
        "~..rs___________|#####################################################|l",
        "~../|___________|#####################################################|l",
        "~../|___________|#####################################################|l",
        "~../|___________|#####################################################|l",
        "~../|___________|#####################################################|l",
        "~../|___________|#####################################################|l",
        ".../|___________|#####################################################|l",
        ".../|__________f|#####################################################|l",
        "////|___________|#####################################################|l",
        "|||||||s||m||s|||||||||||||||||||||||||||||||||||||||||||||||||||||||||L",
        "ooooooooooooooooooouoooooooooooooooooooooooooooooooouooooooooooooooooooo"
      ],
      "palettes": [ "bio_experiment_station_helipad_palette" ],
      "place_loot": [
        { "item": "atgm_heat", "x": 6, "y": 31, "chance": 100, "repeat": [ 0, 2 ] },
        { "item": "belt50", "x": 6, "y": 34, "chance": 100, "repeat": [ 0, 1 ] }
      ],
      "place_vehicles": [
        { "vehicle": "mounted_atgm", "x": 5, "y": 32, "chance": 100, "rotation": 270, "status": 1 },
        { "vehicle": "mounted_m2", "x": 5, "y": 35, "chance": 100, "rotation": 270, "status": 1 }
      ]
    }
  },
  {
    "type": "mapgen",
    "method": "json",
    "om_terrain": [ "helipad_guard_post_magazine" ],
    "weight": 400,
    "object": {
      "fill_ter": "t_floor",
      "rows": [
        "&&&&&&&&&&&&&&&&&&&&&&&&",
        "&&&&&&&&&&&&&&&&&&&&&&&&",
        "&&&&&&&&&&&&&&&&&&&&&&&&",
        "&&&&&&&&&&&&&&&&&&&&&&&&",
        "&&&&&&&&&&&&&&&&&&&&&&&&",
        "&&&&&&&&&&&&&&&&&&&&&&&&",
        "&&&&&&&&&&&&&&&&&&&&&&&&",
        "&&&&&&&&&&&||||||||&&&&&",
        "&&&&&&&&&&&|_____||&&&&&",
        "&&&&&&&&&&&|_____||&&&&&",
        "&&&&&&&&&&&|_____u|&&&&&",
        "&&&&&&&&&&&|_____||&&&&&",
        "&&&&&&&&&&&|_____||&&&&&",
        "&&&&&&&&&&&||||||||&&&&&",
        "&&&&&&&&&&&&&&&&&&&&&&&&",
        "&&&&&&&&&&&&&&&&&&&&&&&&",
        "&&&&&&&&&&&&&&&&&&&&&&&&",
        "&&&&&&&&&&&&&&&&&&&&&&&&",
        "&&&&&&&&&&&&&&&&&&&&&&&&",
        "&&&&&&&&&&&&&&&&&&&&&&&&",
        "&&&&&&&&&&&&&&&&&&&&&&&&",
        "&&&&&&&&&&&&&&&&&&&&&&&&",
        "&&&&&&&&&&&&&&&&&&&&&&&&",
        "&&&&&&&&&&&&&&&&&&&&&&&&"
      ],
      "palettes": [ "bio_experiment_station_helipad_palette" ],
      "place_loot": [
        { "item": "atgm_heat", "x": 13, "y": 9, "chance": 100, "repeat": [ 0, 2 ] },
        { "item": "atgm_heat", "x": 14, "y": 9, "chance": 100, "repeat": [ 0, 2 ] },
        { "item": "atgm_heat", "x": 15, "y": 9, "chance": 100, "repeat": [ 0, 2 ] },
        { "item": "belt50", "x": 6, "y": 34, "chance": 100, "repeat": [ 0, 1 ] }
      ]
    }
  }
]
