[
  {
    "type": "mapgen",
    "method": "json",
    "om_terrain": [ "Fallout_shelter01_s_empty" ],
    "//": "Surface level for fallout shelter 01: a trench-style shelter with ramps leading down and a secondary access in the form of a slope.",
    "//2": "This map is empty of vehicles, other human rubbish, or otherwise. Likely, the intended inhabitants never made it to their shelter.",
    "weight": 100,
    "object": {
      "fill_ter": "t_region_groundcover_barren",
      "rows": [
        "........................",
        "........................",
        "........................",
        "..........++++++++1111..",
        "..........++++++++$dD1..",
        "..........++++++++$dD_..",
        "..........++++++++$dD1..",
        "..........++++++++1111..",
        "..........+++++.........",
        "..........+++++.........",
        "..........+++++.........",
        "..........+++++.........",
        "..........+++++.........",
        "..........+++++.........",
        "..........+++++.........",
        "..........+++++.........",
        "...........+++..........",
        "...........+++.0........",
        "...........+++++++......",
        "...........++++++<......",
        "...........+++++++......",
        "........................",
        "........................",
        "........................"
      ],
      "palettes": [ "fallout_shelter_surface_pallet" ],
      "nested": { "0": { "chunks": [ [ "null", 100 ], [ "5x5_fallout_shelter_access", 100 ] ] } }
    }
  },
  {
    "type": "mapgen",
    "method": "json",
    "om_terrain": [ "Fallout_shelter01_u_empty" ],
    "//": "Underground bunker-level for fallout shelter 01: a trench-style bunker with two access points, a central, small habitable area, and supporting columns and sharp angled access corridors to dampen blast force.",
    "weight": 100,
    "object": {
      "fill_ter": "t_wall_rammed_earth",
      "rows": [
        "                        ",
        "                        ",
        "                        ",
        "          ############  ",
        "          #1####1#.uU#  ",
        "          ##||||||.uU#  ",
        "          ##|1##1#.uU#  ",
        "          ##|##         ",
        "          1#|#1         ",
        "          #|||#         ",
        "          1|||1         ",
        "          #|||#         ",
        "          #|||#         ",
        "          1|||1         ",
        "          #|||#         ",
        "          1#|#1         ",
        "           #|#          ",
        "           #|#          ",
        "           #|1###1      ",
        "           #|||||>      ",
        "           ######1      ",
        "                        ",
        "                        ",
        "                        "
      ],
      "palettes": [ "fallout_shelter_bunker_pallet" ]
    }
  }
]
