[
  {
    "type": "mapgen",
    "method": "json",
    "om_terrain": [ [ "refctr_field" ] ],
    "weight": 100,
    "object": {
      "fill_ter": "t_grass",
      "rows": [
        "........................",
        "........................",
        "........................",
        "........................",
        "........................",
        "........................",
        "........................",
        "........................",
        "........................",
        "........................",
        "........................",
        "........................",
        "........................",
        "........................",
        "........................",
        "........................",
        "........................",
        "........................",
        "........................",
        "........................",
        "........................",
        "........................",
        "........................",
        "........................"
      ],
      "palettes": [ "rc_grounds" ]
    }
  },
  {
    "type": "mapgen",
    "method": "json",
    "om_terrain": [ [ "refctr_fence_NW", "refctr_fence_NE" ], [ "refctr_fence_SW", "refctr_fence_SE" ] ],
    "weight": 100,
    "object": {
      "fill_ter": "t_grass",
      "rows": [
        "~~~~~~~~~~~~~~~~~~~~~~~~~~~~~~~~~~~~~~~~~~~~~~~~",
        "~~~~~~~~~~~~~~~~~~~~~~~~~~~~~~~~~~~~~~~~~~~~~~~~",
        "~~~~~~~~~~~~~~~~~~~~~~~~~~~~~~~~~~~~~~~~~~~~~~~~",
        "~~~~~~~~~~~~~~~~~~~~~~~~~~~~~~~~~~~~~~~~~~~~~~~~",
        "~~~~~~~~~~~~~~~~~~~~~~~~~~~~~~~~~~~~~~~~~~~~~~~~",
        "~~~~~~~~~~~~~~~~~~~~~~~~~~~~~~~~~~~~~~~~~~~~~~~~",
        "~~~~~~~~~~~~~~~~~~~~~~~~~~~~~~~~~~~~~~~~~~~~~~~~",
        "~~~~~~~~~~~~~~~~~~~~~~~~~~~~~~~~~~~~~~~~~~~~~~~~",
        "~~~~~~~~~~~~~~~~~~~~~~~~~~~~~~~~~~~~~~~~~~~~~~~~",
        "~~~~~~~~~~~~~~~~~~~~~~~~~~~~~~~~~~~~~~~~~~~~~~~~",
        "~~~~~~~~~~~~~~~~~~~~~~~~~~~~~~~~~~~~~~~~~~~~~~~~",
        "~~~~~~~~~~~||||||||||||||||||||||||||~~~~~~~~~~~",
        "~~~~~~~~~~~|........................|~~~~~~~~~~~",
        "~~~~~~~~~~~|........................|~~~~~~~~~~~",
        "~~~~~~~~~~~|........................|~~~~~~~~~~~",
        "~~~~~~~~~~~|........................|~~~~~~~~~~~",
        "~~~~~~~~~~~|........................|~~~~~~~~~~~",
        "~~~~~~~~~~~|........................|~~~~~~~~~~~",
        "~~~~~~~~~~~|........................|~~~~~~~~~~~",
        "~~~~~~~~~~~|........................|~~~~~~~~~~~",
        "~~~~~~~~~~~|........................|~~~~~~~~~~~",
        "~~~~~~~~~~~|........................|~~~~~~~~~~~",
        "~~~~~~~~~~~|........................|~~~~~~~~~~~",
        "~~~~~~~~~~~|........................|~~~~~~~~~~~",
        "~~~~~~~~~~~|........................|~~~~~~~~~~~",
        "~~~~~~~~~~~|........................|~~~~~~~~~~~",
        "~~~~~~~~~~~|........................|~~~~~~~~~~~",
        "~~~~~~~~~~~|........................|~~~~~~~~~~~",
        "~~~~~~~~~~~|........................|~~~~~~~~~~~",
        "~~~~~~~~~~~|........................|~~~~~~~~~~~",
        "~~~~~~~~~~~|........................|~~~~~~~~~~~",
        "~~~~~~~~~~~|........................|~~~~~~~~~~~",
        "~~~~~~~~~~~|........................|~~~~~~~~~~~",
        "~~~~~~~~~~~|........................|~~~~~~~~~~~",
        "~~~~~~~~~~~|........................|~~~~~~~~~~~",
        "~~~~~~~~~~~|........................|~~~~~~~~~~~",
        "~~~~~~~~~~~||||||||||||||||||||||||||~~~~~~~~~~~",
        "~~~~~~~~~~~~~~~~~~~~~~~~~~~~~~~~~~~~~~~~~~~~~~~~",
        "~~~~~~~~~~~~~~~~~~~~~~~~~~~~~~~~~~~~~~~~~~~~~~~~",
        "~~~~~~~~~~~~~~~~~~~~~~~~~~~~~~~~~~~~~~~~~~~~~~~~",
        "~~~~~~~~~~~~~~~~~~~~~~~~~~~~~~~~~~~~~~~~~~~~~~~~",
        "~~~~~~~~~~~~~~~~~~~~~~~~~~~~~~~~~~~~~~~~~~~~~~~~",
        "~~~~~~~~~~~~~~~~~~~~~~~~~~~~~~~~~~~~~~~~~~~~~~~~",
        "~~~~~~~~~~~~~~~~~~~~~~~~~~~~~~~~~~~~~~~~~~~~~~~~",
        "~~~~~~~~~~~~~~~~~~~~~~~~~~~~~~~~~~~~~~~~~~~~~~~~",
        "~~~~~~~~~~~~~~~~~~~~~~~~~~~~~~~~~~~~~~~~~~~~~~~~",
        "~~~~~~~~~~~~~~~~~~~~~~~~~~~~~~~~~~~~~~~~~~~~~~~~",
        "~~~~~~~~~~~~~~~~~~~~~~~~~~~~~~~~~~~~~~~~~~~~~~~~"
      ],
      "palettes": [ "rc_grounds" ]
    }
  },
  {
    "type": "mapgen",
    "method": "json",
    "om_terrain": [ [ "refctr_fence_v" ] ],
    "weight": 100,
    "object": {
      "fill_ter": "t_grass",
      "rows": [
        "............|~~~~~~~~~~~",
        "............|~~~~~~~~~~~",
        "............|~~~~~~~~~~~",
        "............|~~~~~~~~~~~",
        "............|~~~~~~~~~~~",
        "............|~~~~~~~~~~~",
        "............|~~~~~~~~~~~",
        "............|~~~~~~~~~~~",
        "............|~~~~~~~~~~~",
        "............|~~~~~~~~~~~",
        "............|~~~~~~~~~~~",
        "............|~~~~~~~~~~~",
        "............|~~~~~~~~~~~",
        "............|~~~~~~~~~~~",
        "............|~~~~~~~~~~~",
        "............|~~~~~~~~~~~",
        "............|~~~~~~~~~~~",
        "............|~~~~~~~~~~~",
        "............|~~~~~~~~~~~",
        "............|~~~~~~~~~~~",
        "............|~~~~~~~~~~~",
        "............|~~~~~~~~~~~",
        "............|~~~~~~~~~~~",
        "............|~~~~~~~~~~~"
      ],
      "palettes": [ "rc_grounds" ]
    }
  },
  {
    "type": "mapgen",
    "method": "json",
    "om_terrain": [ [ "refctr_fence_h" ] ],
    "weight": 100,
    "object": {
      "fill_ter": "t_grass",
      "rows": [
        "~~~~~~~~~~~~~~~~~~~~~~~~",
        "~~~~~~~~~~~~~~~~~~~~~~~~",
        "~~~~~~~~~~~~~~~~~~~~~~~~",
        "~~~~~~~~~~~~~~~~~~~~~~~~",
        "~~~~~~~~~~~~~~~~~~~~~~~~",
        "~~~~~~~~~~~~~~~~~~~~~~~~",
        "~~~~~~~~~~~~~~~~~~~~~~~~",
        "~~~~~~~~~~~~~~~~~~~~~~~~",
        "~~~~~~~~~~~~~~~~~~~~~~~~",
        "~~~~~~~~~~~~~~~~~~~~~~~~",
        "~~~~~~~~~~~~~~~~~~~~~~~~",
        "||||||||||||||||||||||||",
        "........................",
        "........................",
        "........................",
        "........................",
        "........................",
        "........................",
        "........................",
        "........................",
        "........................",
        "........................",
        "........................",
        "........................"
      ],
      "palettes": [ "rc_grounds" ]
    }
  },
  {
    "type": "mapgen",
    "method": "json",
    "om_terrain": [ [ "refctr_fence_entrance_L", "refctr_road", "refctr_fence_entrance_R" ] ],
    "weight": 100,
    "object": {
      "fill_ter": "t_grass",
      "rows": [
        "........................''''________________''''........................",
        "........................''''_______,,_______''''........................",
        "........................''''_______,,_______''''........................",
        "........................''''_______,,_______''''........................",
        "........................''''________________''''........................",
        "........................''''_______,,_______''''........................",
        "........................''''_______,,_______''''........................",
        "........................''''_______,,_______''''........................",
        "........................''''________________''''........................",
        "........................''''_______,,_______''''........................",
        "........................''''_______,,_______''''........................",
        "........................''''_______,,_______''''........................",
        "||||||||||||............''''________________''''............||||||||||||",
        "~~~~~~~~~~~~~~~~~~~~~~~~''''_______,,_______''''~~~~~~~~~~~~~~~~~~~~~~~~",
        "~~~~~~~~~~~~~~~~~~~~~~~~''''_______,,_______''''~~~~~~~~~~~~~~~~~~~~~~~~",
        "~~~~~~~~~~~~~~~~~~~~~~~~''''_______,,_______''''~~~~~~~~~~~~~~~~~~~~~~~~",
        "~~~~~~~~~~~~~~~~~~~~~~~~''''________________''''~~~~~~~~~~~~~~~~~~~~~~~~",
        "~~~~~~~~~~~~~~~~~~~~~~~~''''_______,,_______''''~~~~~~~~~~~~~~~~~~~~~~~~",
        "~~~~~~~~~~~~~~~~~~~~~~~~''''_______,,_______''''~~~~~~~~~~~~~~~~~~~~~~~~",
        "~~~~~~~~~~~~~~~~~~~~~~~~''''_______,,_______''''~~~~~~~~~~~~~~~~~~~~~~~~",
        "~~~~~~~~~~~~~~~~~~~~~~~~''''________________''''~~~~~~~~~~~~~~~~~~~~~~~~",
        "~~~~~~~~~~~~~~~~~~~~~~~~''''_______,,_______''''~~~~~~~~~~~~~~~~~~~~~~~~",
        "~~~~~~~~~~~~~~~~~~~~~~~~''''_______,,_______''''~~~~~~~~~~~~~~~~~~~~~~~~",
        "~~~~~~~~~~~~~~~~~~~~~~~~''''_______,,_______''''~~~~~~~~~~~~~~~~~~~~~~~~"
      ],
      "palettes": [ "rc_grounds" ]
    }
  },
  {
    "type": "mapgen",
    "method": "json",
    "om_terrain": [ [ "refctr_S3e" ] ],
    "//": "Temporary map until I unhardcode the locate mission",
    "weight": 100,
    "object": {
      "fill_ter": "t_grass",
      "rows": [
        "''''________________''''",
        "''''_______,,_______''''",
        "''''_______,,_______''''",
        "''''_______,,_______''''",
        "''''________________''''",
        "''''_______,,_______''''",
        "''''_______,,_______''''",
        "''''_______,,_______''''",
        "''''________________''''",
        "''''_______,,_______''''",
        "''''_______,,_______''''",
        "''''_______,,_______''''",
        "''''________________''''",
        "''''_______,,_______''''",
        "''''_______,,_______''''",
        "''''_______,,_______''''",
        "''''________________''''",
        "''''_______,,_______''''",
        "''''_______,,_______''''",
        "''''_______,,_______''''",
        "''''________________''''",
        "''''_______,,_______''''",
        "''''_______,,_______''''",
        "''''_______,,_______''''"
      ],
      "palettes": [ "rc_grounds" ]
    }
  },
  {
    "type": "mapgen",
    "method": "json",
    "om_terrain": [ [ "refctr_hill_nw", "refctr_hill_ne" ] ],
    "weight": 100,
    "object": {
      "fill_ter": "t_grass",
      "rows": [
        "......................<<<<......................",
        ".....................<<>><<.....................",
        "....................<<>>>><<....................",
        ".........<<<<<<<<<<<<>>##>><<...................",
        "........<<>>>>>>>>>>>>####>><<..................",
        ".......<<>>################>><<.................",
        ".......<>>##################>><<................",
        ".......<>####################>><<...............",
        ".......<>#####################>><<..............",
        "......<<>######################>><<.............",
        ".....<<>>#######################><..............",
        "....<<>#>#######################><..............",
        "...<<>>#########################><..............",
        "..<<>>##########################><..............",
        "..<>>##########################>><..............",
        "..<>##########################>><<..............",
        "..<>##########################><................",
        "..<>##########################><$...............",
        "<<>>##########################<<$$..............",
        "<>>####################+++++.$$$................",
        "<>####################++++++.$$$$...............",
        "<>>####################+++++.$$$................",
        "<<>>##########################<<$$..............",
        "..<>##########################><$..............."
      ],
      "palettes": [ "rc_grounds" ],
      "terrain": {
        "#": "t_wall_rammed_earth",
        "<": "t_earth_ramp_up_low",
        ">": "t_earth_ramp_up_high",
        "+": "t_dirt_underground",
        "$": [ [ "t_region_groundcover", 5 ], [ "t_region_shrub", 5 ], [ "t_region_tree", 1 ] ]
      }
    }
  },
  {
    "type": "mapgen",
    "method": "json",
    "om_terrain": [ [ "refctr_hill_nwt", "refctr_hill_net" ] ],
    "weight": 100,
    "object": {
      "fill_ter": "t_open_air",
      "rows": [
        "||||||||||||||||||||||<<<<||||||||||||||||||||||",
        "|||||||||||||||||||||<<>><<|||||||||||||||||||||",
        "||||||||||||||||||||<<>>>><<||||||||||||||||||||",
        "|||||||||<<<<<<<<<<<<>>..>><<|||||||||||||||||||",
        "||||||||<<>>>>>>>>>>>>....>><<||||||||||||||||||",
        "|||||||<<>>................>><<|||||||||||||||||",
        "|||||||<>>..................>><<||||||||||||||||",
        "|||||||<>....................>><<|||||||||||||||",
        "|||||||<>.....................>><<||||||||||||||",
        "||||||<<>......................>><<|||||||||||||",
        "|||||<<>>.......................><||||||||||||||",
        "||||<<>.>.......................><||||||||||||||",
        "|||<<>>.........................><||||||||||||||",
        "||<<>>..........................><||||||||||||||",
        "||<>>..........................>><||||||||||||||",
        "||<>..........................>><<||||||||||||||",
        "||<>.........................$><||||||||||||||||",
        "||<>........................$$><||||||||||||||||",
        "<<>>.......................$$$<<||||||||||||||||",
        "<>>.......................$$||||||||||||||||||||",
        "<>.........................$||||||||||||||||||||",
        "<>>.......................$$||||||||||||||||||||",
        "<<>>.......................$$$<<||||||||||||||||",
        "||<>.......................$$$><||||||||||||||||"
      ],
      "palettes": [ "rc_grounds" ],
      "terrain": {
        "|": "t_open_air",
        "<": "t_earth_ramp_down_low",
        ">": "t_earth_ramp_down_high",
        "$": [ [ "t_region_groundcover", 8 ], [ "t_region_shrub", 9 ], [ "t_region_tree", 1 ] ]
      }
    }
  }
]
